;Compiler Error Messages
NamedParameterMustBeReference=Nome do parâmetro deve ser um identificador.
NamedParametersNotAllowed=Parâmetros são permitidos apenas com construtores.
AmbiguousName=Referência ambígua {0}: {1}.
UnknownName=Identificador desconhecido: {0}.
NotAPublicFieldOrProperty=O nome {0} não representa um campo ou propriedade pública do tipo {1}.
MissingConstructor=O tipo {0} não possui nenhum constructor com a assinatura {1}.
AttributeResolution=Erro durante a aplicação do atributo {0}: {1}.
StepExecution=Erro durante a execução do passo {0}: {1}.
ICompilerStepInterface=O tipo {0} não implementa a interface ICompilerStep.
RequiredAttribute=O elemento {0} deve conter um atributo de nome {1}.
InvalidAssemblySetup=AssemblyBuilder não foi configurado corretamente.
BindingManager.UnboundNode=O nó {0} na posição {1} não foi resolvido corretamente.
MethodArgumentCount=Nenhuma versão do método {0} aceita {1} parâmetro(s).
MethodSignature=A versão mais próxima do método '{1}' não é compatível com a lista de argumentos '{0}'.
NameNotType=O nome {0} não denota um tipo válido.
MemberNotFound=Membro '{0}' não encontrado.
InvalidNamespace=Espaço {0} não encontrado, talvez você tenha esquecido de adicionar uma referência?
IncompatibleExpressionType=Tipo da expressão '{1}' incompatível com destino ('{0}').
NoApropriateOverloadFound=Nenhuma versão compatível com os argumentos '{0}' foi encontrada.
InvalidArray=Somente arrays unidimensionais são suportados.
BoolExpressionRequired={0} não pode ser utilizado em um contexto booleano.
AmbiguousTypeReference=Referência de tipo ambígua: {0}.

;Attribute Messages
InvalidNodeForAttribute=Este atributo só pode ser aplicado a nós do tipo {0}.

;Mensagens do ANTLR
NoViableAltException=Token inesperado: {0}.

;BooC Messages
BooC.Errors={0} erro(s).
BooC.ProcessingTime={0} módulo(s) processado(s) em {1}ms após {2}ms para configuração do ambiente de compilação.
BooC.FatalError=Erro fatal: {0}.
BooC.InvalidOption=Opção inválida: {0}.
BooC.UnableToLoadAssembly=Não foi possível carregar a montagem {0}.
BooC.UnableToLoadPipeline=Não foi possível carregar a pipeline {0}, causa: {1}.
BooC.NoPipeline=Nenhuma pipeline de compilação especificada (/p:<PIPELINE>)
BooC.NoInputSpecified=Nenhum fonte especificado
BooC.NoOutputSpecified=Arquivo de saída não especificado

;Boo.Lang
ArgumentNotEnumerable=Argumento não é enumerável (não implementa System.Collections.IEnumerable).
CantEnumerateNull=null não é enumerável.
UnpackListOfWrongSize=Desempacotamento de lista de tamanho errado.
CantUnpackNull=null não pode ser desempacotado.
UnpackArrayOfWrongSize=Desempacotamento de array de tamanho errado. (esperado={0}, real={1}).

